1111111111
1000000001
10E0P0CC01
1000000001
1111111111
