1111111111111111111
1C0C0C0C010C0C0C0C1
1011011101011101101
1C110111010111011C1
100000000F000000001
1011010111110101101
1C00F100010001F00C1
1111011101011101111
1001010000000101001
1111010110110101111
1C000001CCC100000E1
1111010111110101111
1001010000000101001
1111010111110101111
1C00F000010000F00C1
1011011101011101101
1C0100000P0000010C1
1101010111110101011
1C0C01000100010C0C1
1011111101011111101
1C0C0C0C0C0C0C0C0C1
1111111111111111111
