11111111111111111111111111111111111111111111111111111
1E10C0C0C0C0C010C0C0C0C010C0C0C0C0C0C0C0C0C0C0C010001
101011111111101011111010111110111111111111111110101C1
101000101000001010000010C0C0C010001000000000101010101
101110101011111110111111111111101110111110101010101C1
10C0C01010C0C0C01010000010001000000010000010001010101
111111101111111010101110101011101111101111111010111C1
10C0C0C01000000010C0C0100010001000100010C010C01000101
101111111011111111111111111110111110111011101111101C1
10C0C0C0C01000100000001000000010000010001000100000101
101111111110101010111010111111101111101110111011111C1
1000000010001010101000101000100010C0C010C0C0101000101
111111101110101010101110101110101111101011111010101C1
10100010000010101010000010100010100010001010001010001
101010111111101110111111101011101010101110101110111C1
100010C0C0C010001010C0C0C0C01010001010000010100010101
101111111011111010101111111110111110111110101011101C1
1010C0C01010C0101010C0C0C0C01000100010001010100010101
101011101010101010111111111011101011101011101110101C1
10001000100010000010C0C0C0C0C0C01000001000000000100P1
11111111111111111111111111111111111111111111111111111
