1111111111
1000000001
1111111111
1P010010E1
1001001001
1000000001
110CF0C011
1011111101
1000000001
1111111111