11111111111111111
10000000000000001
10000000000000001
11111111111111111
1F00C1C000C1C00E1
10000100000100001
1000C1C0F0C1C0001
10000100000100001
1C00C1C000C1C00C1
10000000000000001
1C000000F000000C1
11P0C0000000C0011
101110C0C0C011101
10000111111100001
10000000000000001
10000000000000001
11111111111111111
