1111111111
1010000001
1CE0P0CC01
1010000001
1111111111
