111111111111111111111111111111111111111111
111111111111111111111111110000000111111111
111111111111111111111111110000000111111111
111111111111111111111111110000000111111111
11111111111111111111111111000F000101111111
1100000000000000000000000000000000C0111111
1100C00C00C00C00C00C00C00C0000000101111111
110000000000000000000000000000000111111111
110010010010010010010010010000000000000111
1100C00C00C00C00C00C00C00C00000000C00C0011
110000000000000000000000000000000000000001
1EP0000000000000000000000000000000000F0001
110000000000000000000000000000000000000001
1100C00C00C00C00C00C00C00C00000000C00C0011
110010010010010010010010010000000000000111
110000000000000000000000000000000111111111
1100C00C00C00C00C00C00C00C0000000101111111
1100000000000000000000000000000000C0111111
11111111111111111111111111000F000101111111
111111111111111111111111110000000111111111
111111111111111111111111110000000111111111
111111111111111111111111110000000111111111
111111111111111111111111111111111111111111
