1111111111
1010000001
1CE000CC01
1010000001
1111111111