1111111111
1000000001
1000011111
10E0P0F011
1000010011
10000110C1
1111111111
