1111111111
10C0100001
10P010E001
1000100001
1111111111

