1111111111111
1F0C10000CCC1
1000101011111
1C10P01000001
1111001000001
10F00010F00E1
1111111111011
1F00000000001
1100000000001
10C0C0FFF0001
1111111111111
